1111111111111111111
1x.222222222.222.11
1.121212121212121.1
1222.22.222.2222221
1212121212121212121
1.2222.2222222222.1
12121212121.1212121
122222222222222.221
121.12121.121212121
12.2222.2222222.221
1212121212121212121
122222222222.222221
1.121.12121212121.1
11.22222.2222222.21
1111111111111111111