1111111111111111111
1.....2222222.....1
1.x..2222.2222..x.1
1...222.222.222...1
1..22.222.222.22..1
1.22222.222.22222.1
12222.222.222.22221
122.222.222.222.221
12222.222.222.22221
1.22222.222.22222.1
1..22.222.222.22..1
1...222.222.222...1
1.x..2222.2222..x.1
1.....2222222.....1
1111111111111111111