1111111111111111111
1x..22222222222..x1
1.111211.1.112111.1
1.1.22222222222.1.1
121211211.112112121
1222122222222212221
12122.1211121.22121
12.2111..1..1112.21
12122.1211121.22121
1222122222222212221
121211211.112112121
1.1.22222222222.1.1
1.111211.1.112111.1
1x..22222222222..x1
1111111111111111111