11111111111111111111111111111111111
1x..222222222222222222222222222...1
1.11.111.11121112121112111.111.11.1
1.12222222212...212...21222222221.1
12.21.1212..21112.21112..2121.12.21
1212..12121.212.212.212.12121..2121
12121112121121212121212112121112121
1212222222212.2121212.2122222222121
12.21121112121212.21212121112112.21
1212.12.1.2.212.212.212.2.1.2.12121
1212.12.1.2.212.212.212.2.1.2.12121
12.21121112121212.21212121112112.21
1212222222212.2121212.2122222222121
12121112121121212121212112121112121
1212..12121.212.212.212.12121..2121
12.21.1212..21112.21112..2121.12.21
1.12222222212...212...21222222221.1
1.11.111.11121112121112111.111.11.1
1...222222222222222222222222222...1
11111111111111111111111111111111111