1111111111111111111
1..2222..x..2222..1
121.11111.11111.121
121.12221212221.121
121.12122222121.121
1.1.2.2211122.2.1.1
1.11.12.222.21.11.1
1x.221.12121.122.x1
1.11.12.222.21.11.1
1.1.2.2211122.2.1.1
121.12122222121.121
121.12221212221.121
121.11111.11111.121
1..2222..x..2222..1
1111111111111111111