11111111111111111111111111111111111
1....2333333...3..1...33213.231...1
1..333..333333331..1..3321.31231..1
111133322.1...311333113.333..123131
1...333....1..33..22....33..133.231
1.333..33223332111222133...1..12231
1...2....33..1.2..333.3.33133.....1
13323.12233131.223111331..332213211
1.2.3333333.1..3...23...1.33311...1
13333...33322233....3...1..23112..1
1.33333333111332223333.222222..2211
1..3..3.1...3333....3...11.323321.1
1..3333..3333..3.1..3..1...3...3331
12221.233..22..33.3....1...33212..1
1..2..2.13.2.1111..333....211333331
1..3..2..1..31331223..31113.3.....1
1...132211233223..32.....3..3222111
133..33322231111....333223333.33..1
1..x3..3.......2..3333..333.32...11
11111111111111111111111111111111111