11111111111111111111111111111111111
10...2333333...3..1...33213.231...1
1..333..333333331..1..3321.31231..1
111133322.1...333333333.333..123131
1...333....1..33..11....33..133.231
1.333..33223332111222133...1..12231
1...2....33..1.2..333.3.33333.....1
13323.12233131.223333331..332213211
1.2.3333333.1..3...23...1.33311...1
13333...33322233....3...1..23112..1
1.33333333333333333333333.333..2211
1..3..3.1...3333....3...11.323321.1
1..3333..3333..3.1..3..1...3...3331
12221.333..22..33.3....1...33212..1
1..2..3.13.2.1111..333....211333331
1..3..3..1..31331223..31113.3.....1
1...133211233333..32.....3..3222111
133..33333333333....333223333.33..1
1...3..3.......2..3333..333.32...11
11111111111111111111111111111111111